0000000000000000000011111110011111111111110000000000000000000000000000000000000111111011100000000000
0000000000000000000111111111111111111111111100000000000000000000000000000000110111111111110000000100
0000010000000000001110011111110111111000111111000000000000000000000000000011111111111111111100101111
0000111000000000011100011111111111110000011111111000000000000000000001110111111111100100011111111111
1101111000000001111100001111111111100000000011111000000100010000000111111111001111000000011111111111
1111111111000011111110011111111000000000000011111110001111110000000111111110000000000000010111110110
1111111111111111111111111111111000001100001011111111111111110011001111111110000000000000000111100000
1111111111111111111111111111110000001111011111111111111111111111111111111110000000000000000011100000
1111111111111111111111111111111000001111111111111111111110011111111111100111110000000000000000000000
1111111111111111111111111111111100001111111101111111111111001100111111100011111100000000000000000000
1111111111111111111111111111111110111110111100110000100111100000111110000001111100000000000000000000
1111111111111111111101011111111111111111111000000000000111100001111100000000001110000000010000000000
0111111111111111111101101111111111111111111111100000000111100011100000000000000111000001110000000000
1111111111111111111111101111111111011111111111100000000011101111000000000000000011100001110000000000
1111111111111111111111101011111111111110111111111100010001111110000000000000000001111111110000000000
1111111111111001111111100000000011111110111111111111111000111100000000000000000001111111000000000000
1111111111111001111111100000000001101100111111111111111010010000000000000000000000111110000000000110
1111111111110001001100000000000000000101111110111111111110000000000000000000000000001000000000001111
1011111110000000000000000000000000000001111000011110101110000000000000000000000000000000000000001111
1111111110000001000000100100000000000001100000011000000100000111000000000000000000000000000000001111
1111111110001111110001111100000000000000000000000100000000111111100000000000000000000000000000000111
1100010010011111111111111110000000000011000011111111011001111111110000110000000000000000000000000111
0001110000011111111111111111100010000011100111111111111111111011111001111000010000110001111101011111
1111111111111110101111111111111111111111111111111111111111111000011111111111111111111111111111111110
1111111111111100000111111101111111111111111101011111100111111000011111001111111111111111111111111110
